Windows의 기본 명령어
-DIR : 현재 디렉토리의 파일 목록을 표시함
-COPY :  파일을 복사함
-DEL : 파일을 삭제함
-TYPE : 파일의 내용을 표시함
-REN : 파일의 이름을 변경함
-MD : 디렉토리를 생성함
-CD : 동일한 드라이브에서 디렉터리의 위치를 변경함
-CLS : 화면의 내용을 지움
-ATTRIB : 파일의 속성을 변경함
-FIND : 파일에서 문자열을 찾음
-CHKDSK : 디스크 상태를 점검함
-FORMAT : 디스크 표면을 트랙과 섹터로 나누어 초기화 함
-MOVE : 파일을이동함

UNIX/LINUX기본 명령어
-cat : 파일 내용을 화면에 표시함
-cd : 디렉토리의 위치를 변경함
-chmod : 파일의 보호모드를 설정하여 파일의 사용허가를 지정함 예) chmod u = rwx abc.txt -> 유저에게 abc.txt파일의 읽기(r), 쓰기(w), 실행(x)권한을 부여한다
-chown : 파일 송자와 그룹을 변경함
-cp : 파일을 복사함
-rm : 파일을 삭제함
-find : 파일을 찾음
-fsck : 파일 시스템을 검사하고 보수함
-kill : PID를 이용하여 프로세스를 종료함
-fork : 새로운 프로세스를 생성함
-killall : 프로세스의 이름을 이용하여 프로세스를 종료함
-ls : 현재 디렉토리의 파일 목록을 표시함
-mkdir : 디렉토리를 생성함
-rmdir : 디렉토리를 삭제함
-mv : 파일을 이동함
-ps : 현재 실행중인 프로세스를 표시함
-pwd : 현재 작업중인 디렉토리 경로를 화면에 표시함
-top : 시스템의 프로세스와 메모리 사용 현황을 표시함
-who : 현재 시스템에 접속해 있는 사용자를 표시함


rwx 8진법 계산법

-rwx rwx r-x
ㄴ -          rwx    rwx        r-x              111 111 101
파일 구분      소유자   그룹      기타 사용자
